1111111111111
1C000C00C00C1
1000000000001
100011100C001
1000111000011
10C0111000011
100E00000P011
1111111111111
